1111111111111111111111111
1111111111111111111111111
1100000000000000000000011
1101000000000000000001011
1100000000000000000000011
1100000000000000000000011
1100000000000000000000011
1100000000000000000000011
1100000000000000000000011
1100000000000000000000011
1100000000000000000000011
1100000000000000000000011
1100000000000000000000011
1100000000000000000000011
1100000000000000000000011
1100000000000000000000011
1100000000000000000000011
1100000000000000000000011
1100000000000000000000011
1101000000000000000001011
1100000000000000000000011
1111111111111111111111111
1111111111111111111111111