_________________________
_________________________
__722222222222222222222__
__6______________________
__6______________________
__6______________________
__6______________________
__6______________________
__6______________________
__6______________________
__6______________________
__6______________________
__6______________________
__6______________________
__6______________________
__6______________________
__6______________________
__6______________________
__6______________________
__6______________________
__6______________________
_________________________
_________________________
