1111111111111111111111111
1111111111111111111111111
1110000000000000000000011
1101100000000000000000011
1100011000000000000000011
1100000110000000000000011
1100000001100000000000011
1100000000011000000000011
1100000000000110000000011
1100000000000001100000011
1100000000000000011000011
1100000000000000000000011
1100000000000000000000011
1100000000000000000000011
1100000000000000000000011
1100000000000000000000011
1100000000000000000000011
1100000000000000000000011
1100000000000000000000011
1100000000000000000000011
1100000000000000000000011
1111111111111111111111111
1111111111111111111111111